....................
....................
....................
....................
.B........B....B....
....................
....................
.....B..............
....................
..............B.....
....................
....................
..........-------...
....-----...........
..........-----.....
....................
...------...........
...---......----....
.................--.
..----.........--...
........----........
................--..
.................1..
####################